33232344000121003304041200020120420404303023231000434400403421001
30000030401020204000000010204000201000000000302020300000301020200
32041000430112040201220201041102000443040200210114024004320004040
00001020201010200000100010401040004030402000002040403040002020101
00430022430202024343040204240023423204434221041024420101044404100
10402040300040102030004020404010304010202020101020001040400030202
20024201010134023201210202011101020424023400120402020202040242020
40100040002000201010404020400040100000400020402040201000100000004
04034301034242420221012202202244201114000342002004122004004004210
10000000200030401000001040104020001020001020101040004010104000402
04023204430124012400200030042000200011001200120021020100010042002
30404010403010200030204000100040201000102010103020400040402000300
30420114124204041343022242240001321100022200004402240204232403420
20201020200040001030402020004000000020104040100040200000000040304
00002100020340012202120232024304220004040401300121040003420012001
30400020402020004000400000004020000010102020000010003010301020400
33440340024343320024140003422002244222021433434201234002201412100
00001030403020201000202020202020003000402020400020400020200000103
02020200200442010400220001041002340010004000040340002000440044044
30204040001020304020100040002010300040102000000020204040302040403
31000400011003424434010411020020423402220401022324400000021204432
00101020004010204010401020101020002010102020402020302040201020203
04020104120204042103420122001001240211044401200443000401100124013
00204020100000100010200040201020202020003010102040101000001030202
22001011002242242000424203402414022002240410121101110344010342344
10200010001030002020204010300000202040404020400000004030000020400
01042201240224000004210024034300200100021003400011022004040430043
20001020201040204000002010204040100010000000204000404000104000102
22010410221201334232034302220340120001021344002222420104322402122
30400040200040004020403040204040100010404000201020402010201020004
22041201310440020002440100024402200134034002040243020401040421041
20104020001030002000204040002040200030203000200020202000304010000
02013232400240401211002422424224243042310424211214140202404404400
20203010204000402040202000400000204040201010404000400040204040304
22002404220004040203440212042202310404042400010411020001320211011
00402000204040202020302010102000001040201020002040200020402020101
42200022200204002020000204000434400101011442010211040110012101000
00000000202040200040204000104020400000404030202040402040300010400
00021401240200021004340101012404020400034404440000002404430101024
00200020101010401040402020404040004020103040003040400010202020102
44013322012000140030434002442202041004040002144003434431004032334
40104020202020203000202020400010201010101000400010200020003020002
01010100040344024204320442020102210411002000430021043004310000010
20404020400020404030100030404040200020200010404010002000002000202
34120242244403400244010042010001211100434434022014440040403400203
30202000004020403000202000400000201010402040102000001030201000203
32022401240240044002430402011002110204012201200012042202210201004
00003030302040204040004030400010000040104020300010002040000000004
01143443402230120410233044243312040443240402404300210340433333240
40002040000000401000400030104040004000102020203020204020301020002
44002104040101013101100431024004440243000204440102042404300214003
30000010204010302040000020202010404040002010004040404000401040203
20020002402403404321003444000412002101334004041102110440423100203
00400010002010003040200020400010401040102010401000401040200000202
04011103430414003001200401040404420440020200430044042000220340020
40000010202010003040004010000040300030404040004030003010004000103
24441200012201021040101103431012234414430223442343002102011434024
20000000400020204040200000201020300020000020200000004040102020404
22012004420114024301040020011001200202044303430000000202000120020
00200000404000102040100040400040000040203010000020402020002000001
02220002141204141444011120020424000004204231020343400244144401242
20104020401040204040400020101000102020400010004020404000203040404
00021403400242034202100401011404000340044004000102001404010101002
30402020002030002000203040404010101000404010100010301020200020400
40340440200210220201224200441012043040021011121402401443242102220
